type octile
height 37
width 50
map
@@@@@@@@@@@@@@@@@@@@@@@@@@@@@@@@@@@@@@@@@@@@@@@@@@
@.CCCCCCCCCCCCCCCCCCCCCCCCCCCCCCCCCCCCCCCCCCCCCC.@
@C..............................................C@
@C.EE.EE.SSSSSSSSSS.SSSSSSSSSS.SSSSSSSSSS.EE.EE.C@
@C.EE.EE.@@@@@@@@@@.@@@@@@@@@@.@@@@@@@@@@.EE.EE.C@
@C.EE.EE.SSSSSSSSSS.SSSSSSSSSS.SSSSSSSSSS.EE.EE.C@
@C..............................................C@
@C.EE.EE.SSSSSSSSSS.SSSSSSSSSS.SSSSSSSSSS.EE.EE.C@
@C.EE.EE.@@@@@@@@@@.@@@@@@@@@@.@@@@@@@@@@.EE.EE.C@
@C.EE.EE.SSSSSSSSSS.SSSSSSSSSS.SSSSSSSSSS.EE.EE.C@
@C..............................................C@
@C.EE.EE.SSSSSSSSSS.SSSSSSSSSS.SSSSSSSSSS.EE.EE.C@
@C.EE.EE.@@@@@@@@@@.@@@@@@@@@@.@@@@@@@@@@.EE.EE.C@
@C.EE.EE.SSSSSSSSSS.SSSSSSSSSS.SSSSSSSSSS.EE.EE.C@
@C..............................................C@
@C.EE.EE.SSSSSSSSSS.SSSSSSSSSS.SSSSSSSSSS.EE.EE.C@
@C.EE.EE.@@@@@@@@@@.@@@@@@@@@@.@@@@@@@@@@.EE.EE.C@
@C.EE.EE.SSSSSSSSSS.SSSSSSSSSS.SSSSSSSSSS.EE.EE.C@
@C..............................................C@
@C.EE.EE.SSSSSSSSSS.SSSSSSSSSS.SSSSSSSSSS.EE.EE.C@
@C.EE.EE.@@@@@@@@@@.@@@@@@@@@@.@@@@@@@@@@.EE.EE.C@
@C.EE.EE.SSSSSSSSSS.SSSSSSSSSS.SSSSSSSSSS.EE.EE.C@
@C..............................................C@
@C.EE.EE.SSSSSSSSSS.SSSSSSSSSS.SSSSSSSSSS.EE.EE.C@
@C.EE.EE.@@@@@@@@@@.@@@@@@@@@@.@@@@@@@@@@.EE.EE.C@
@C.EE.EE.SSSSSSSSSS.SSSSSSSSSS.SSSSSSSSSS.EE.EE.C@
@C..............................................C@
@C.EE.EE.SSSSSSSSSS.SSSSSSSSSS.SSSSSSSSSS.EE.EE.C@
@C.EE.EE.@@@@@@@@@@.@@@@@@@@@@.@@@@@@@@@@.EE.EE.C@
@C.EE.EE.SSSSSSSSSS.SSSSSSSSSS.SSSSSSSSSS.EE.EE.C@
@C..............................................C@
@C.EE.EE.SSSSSSSSSS.SSSSSSSSSS.SSSSSSSSSS.EE.EE.C@
@C.EE.EE.@@@@@@@@@@.@@@@@@@@@@.@@@@@@@@@@.EE.EE.C@
@C.EE.EE.SSSSSSSSSS.SSSSSSSSSS.SSSSSSSSSS.EE.EE.C@
@C..............................................C@
@.CCCCCCCCCCCCCCCCCCCCCCCCCCCCCCCCCCCCCCCCCCCCCC.@
@@@@@@@@@@@@@@@@@@@@@@@@@@@@@@@@@@@@@@@@@@@@@@@@@@