type octile
height 35
width 59
map
@@@@@@@@@@@@@@@@@@@@@@@@@@@@@@@@@@@@@@@@@@@@@@@@@@@@@@@@@@@
@@@@@..@@@.CC.@@@.CC.@@@.CC.@@@.CC.@@@.CC.@@@.CC.@@@..@@@@@
@@@@@.E@@@E..E@@@E..E@@@E..E@@@E..E@@@E..E@@@E..E@@@E.@@@@@
@@@@@..@@@....@@@....@@@....@@@....@@@....@@@....@@@..@@@@@
@@@@@..CCC....CCC....CCC....CCC....CCC....CCC....CCC..@@@@@
@......C.C....C.C....C.C....C.C....C.C....C.C....C.C.C.C.C@
@.E..................................................C.C.C@
@@@@CC...............................................C.C.C@
@@@@C....SSS.SSS.SSS.SSS.SSS.SSS.SSS.SSS.SSS.SSS.....C.C.C@
@@@@CC..S@@@S@@@S@@@S@@@S@@@S@@@S@@@S@@@S@@@S@@@S.........@
@.E.....S@@@S@@@S@@@S@@@S@@@S@@@S@@@S@@@S@@@S@@@S.......E.@
@C.......SSS.SSS.SSS.SSS.SSS.SSS.SSS.SSS.SSS.SSS.....CC@@@@
@C......S@@@S@@@S@@@S@@@S@@@S@@@S@@@S@@@S@@@S@@@S.....C@@@@
@.E.....S@@@S@@@S@@@S@@@S@@@S@@@S@@@S@@@S@@@S@@@S....CC@@@@
@@@@CC...SSS.SSS.SSS.SSS.SSS.SSS.SSS.SSS.SSS.SSS........E.@
@@@@C...S@@@S@@@S@@@S@@@S@@@S@@@S@@@S@@@S@@@S@@@S........C@
@@@@CC..S@@@S@@@S@@@S@@@S@@@S@@@S@@@S@@@S@@@S@@@S........C@
@.E......SSS.SSS.SSS.SSS.SSS.SSS.SSS.SSS.SSS.SSS........E.@
@C......S@@@S@@@S@@@S@@@S@@@S@@@S@@@S@@@S@@@S@@@S....CC@@@@
@C......S@@@S@@@S@@@S@@@S@@@S@@@S@@@S@@@S@@@S@@@S.....C@@@@
@.E......SSS.SSS.SSS.SSS.SSS.SSS.SSS.SSS.SSS.SSS.....CC@@@@
@@@@CC..S@@@S@@@S@@@S@@@S@@@S@@@S@@@S@@@S@@@S@@@S.......E.@
@@@@C...S@@@S@@@S@@@S@@@S@@@S@@@S@@@S@@@S@@@S@@@S........C@
@@@@CC...SSS.SSS.SSS.SSS.SSS.SSS.SSS.SSS.SSS.SSS.........C@
@.E.....S@@@S@@@S@@@S@@@S@@@S@@@S@@@S@@@S@@@S@@@S.......E.@
@.......S@@@S@@@S@@@S@@@S@@@S@@@S@@@S@@@S@@@S@@@S....CC@@@@
@C.C.C...SSS.SSS.SSS.SSS.SSS.SSS.SSS.SSS.SSS.SSS......C@@@@
@C.C.C...............................................CC@@@@
@C.C.C..................................................E.@
@C.C.C.C.C....C.C....C.C....C.C....C.C....C.C....C.C......@
@@@@@..CCC....CCC....CCC....CCC....CCC....CCC....CCC..@@@@@
@@@@@..@@@....@@@....@@@....@@@....@@@....@@@....@@@..@@@@@
@@@@@.E@@@E..E@@@E..E@@@E..E@@@E..E@@@E..E@@@E..E@@@E.@@@@@
@@@@@..@@@.CC.@@@.CC.@@@.CC.@@@.CC.@@@.CC.@@@.CC.@@@..@@@@@
@@@@@@@@@@@@@@@@@@@@@@@@@@@@@@@@@@@@@@@@@@@@@@@@@@@@@@@@@@@